Dato;Hovedstaden;Sjælland;Syddanmark;Midtjylland;Nordjylland;Ukendt Region;Total
2020-03-01;1;0;0;0;0;0;1
2020-03-02;0;0;0;0;0;0;0
2020-03-03;1;0;0;0;0;0;1
2020-03-04;0;0;0;0;0;0;0
2020-03-05;1;0;0;0;0;0;1
2020-03-06;3;1;0;0;0;0;4
2020-03-07;0;0;0;0;0;0;0
2020-03-08;3;0;0;0;0;0;3
2020-03-09;3;6;0;0;0;0;9
2020-03-10;6;5;1;3;0;0;15
2020-03-11;4;4;2;0;0;0;10
2020-03-12;3;6;1;7;1;0;18
2020-03-13;13;2;3;7;1;0;26
2020-03-14;9;6;3;3;3;0;24
2020-03-15;18;5;3;4;3;0;33
2020-03-16;23;12;5;3;2;0;45
2020-03-17;25;8;5;6;3;0;47
2020-03-18;21;13;5;4;4;0;47
2020-03-19;29;6;6;4;5;0;50
2020-03-20;33;14;10;5;2;0;64
2020-03-21;14;10;4;4;2;0;34
2020-03-22;22;7;3;7;3;0;42
2020-03-23;43;11;10;16;5;0;85
2020-03-24;37;11;12;14;6;1;81
2020-03-25;40;18;12;14;6;0;90
2020-03-26;41;11;7;12;7;1;79
2020-03-27;38;15;18;11;5;0;87
2020-03-28;31;21;16;10;5;0;83
2020-03-29;25;9;9;4;4;1;52
2020-03-30;39;13;4;11;1;1;69
2020-03-31;28;8;4;9;2;0;51
2020-04-01;29;8;13;6;4;1;61
2020-04-02;38;13;6;10;5;0;72
2020-04-03;33;8;8;11;12;0;72
2020-04-04;26;7;0;7;3;1;44
2020-04-05;23;5;4;2;1;1;36
2020-04-06;28;10;7;4;1;1;51
2020-04-07;36;8;6;6;0;0;56
2020-04-08;14;5;5;3;1;0;28
2020-04-09;18;7;1;8;0;0;34
2020-04-10;16;7;1;6;3;1;34
2020-04-11;17;5;5;3;1;0;31
2020-04-12;13;5;3;4;2;0;27
2020-04-13;18;7;1;4;0;0;30
2020-04-14;22;8;3;10;1;1;45
2020-04-15;12;11;1;5;1;0;30
2020-04-16;17;6;1;9;0;0;33
2020-04-17;13;10;2;2;0;0;27
2020-04-18;15;9;1;2;0;0;27
2020-04-19;20;9;0;4;0;1;34
2020-04-20;16;11;2;4;0;0;33
2020-04-21;18;13;2;5;0;0;38
2020-04-22;15;9;3;2;0;0;29
2020-04-23;16;11;1;4;0;1;33
2020-04-24;9;9;1;2;1;0;22
2020-04-25;18;7;0;1;1;0;27
2020-04-26;20;2;1;3;0;0;26
2020-04-27;8;11;0;2;0;0;21
2020-04-28;12;2;1;0;0;0;15
2020-04-29;9;4;0;1;1;0;15
2020-04-30;10;5;0;1;0;1;17
2020-05-01;9;5;1;1;0;0;16
2020-05-02;14;5;0;5;0;0;24
2020-05-03;13;3;0;0;0;0;16
2020-05-04;8;3;0;3;0;1;15
2020-05-05;8;8;0;0;0;0;16
2020-05-06;4;2;0;0;0;0;6
2020-05-07;11;4;0;0;0;0;15
2020-05-08;6;2;1;0;0;0;9
2020-05-09;4;3;0;3;0;0;10
2020-05-10;7;2;1;0;0;0;10
2020-05-11;6;1;1;0;0;0;8
2020-05-12;6;0;0;2;0;0;8
2020-05-13;4;2;0;0;0;0;6
2020-05-14;9;2;2;0;0;0;13
2020-05-15;5;7;4;0;1;0;17
2020-05-16;1;1;2;1;0;0;5
2020-05-17;2;0;0;2;0;0;4
2020-05-18;9;2;2;1;0;0;14
2020-05-19;4;2;0;1;0;0;7
2020-05-20;2;3;0;2;0;0;7
2020-05-21;3;3;0;0;0;0;6
2020-05-22;9;2;0;2;0;0;13
2020-05-23;5;3;0;1;0;0;9
2020-05-24;1;1;0;0;0;0;2
2020-05-25;4;0;2;0;0;0;6
2020-05-26;7;0;3;0;1;0;11
2020-05-27;5;2;0;0;0;0;7
2020-05-28;5;0;0;0;0;0;5
2020-05-29;8;1;0;0;0;0;9
2020-05-30;5;1;0;1;0;0;7
2020-05-31;3;0;1;0;0;0;4
2020-06-01;3;0;1;1;0;0;5
2020-06-02;4;2;0;0;0;0;6
2020-06-03;1;2;0;0;0;0;3
2020-06-04;2;2;1;0;0;0;5
2020-06-05;7;1;1;0;0;0;9
2020-06-06;2;0;0;0;0;0;2
2020-06-07;3;0;1;0;0;0;4
2020-06-08;3;1;0;0;0;1;5
2020-06-09;0;1;0;0;0;0;1
2020-06-10;0;0;0;0;1;0;1
2020-06-11;0;0;0;0;1;0;1
2020-06-12;3;2;0;0;1;0;6
2020-06-13;3;1;0;0;0;0;4
2020-06-14;1;0;0;0;0;0;1
2020-06-15;1;1;0;0;0;0;2
2020-06-16;2;3;0;0;1;1;7
2020-06-17;2;0;1;0;2;0;5
2020-06-18;1;0;0;0;1;0;2
2020-06-19;2;2;0;0;0;0;4
2020-06-20;1;1;0;0;2;0;4
2020-06-21;2;0;0;1;1;0;4
2020-06-22;2;1;0;0;2;0;5
2020-06-23;1;0;0;2;1;0;4
2020-06-24;3;0;0;0;3;0;6
2020-06-25;3;1;0;0;1;0;5
2020-06-26;1;0;0;0;0;0;1
2020-06-27;1;1;0;1;1;0;4
2020-06-28;1;1;0;0;4;0;6
2020-06-29;1;0;0;0;2;0;3
2020-06-30;0;0;0;0;0;0;0
2020-07-01;1;1;0;0;0;0;2
2020-07-02;2;0;1;0;1;0;4
2020-07-03;0;0;0;1;0;0;1
2020-07-04;0;0;0;0;0;0;0
2020-07-05;1;0;1;0;0;0;2
2020-07-06;1;1;0;0;0;0;2
2020-07-07;1;0;0;0;1;0;2
2020-07-08;0;0;0;0;1;0;1
2020-07-09;1;1;1;0;0;0;3
2020-07-10;1;0;0;0;2;0;3
2020-07-11;4;0;0;0;1;0;5
2020-07-12;0;0;0;0;0;0;0
2020-07-13;0;0;0;0;0;0;0
2020-07-14;2;0;0;1;0;0;3
2020-07-15;2;1;0;0;0;0;3
2020-07-16;1;0;0;0;0;0;1
2020-07-17;2;1;0;0;0;0;3
2020-07-18;2;0;0;0;0;0;2
2020-07-19;1;1;0;0;0;0;2
2020-07-20;2;1;0;0;0;0;3
2020-07-21;2;0;0;0;0;0;2
2020-07-22;3;0;0;1;0;0;4
2020-07-23;0;0;0;0;1;0;1
2020-07-24;0;1;1;0;0;0;2
2020-07-25;2;2;1;0;0;0;5
2020-07-26;1;1;0;0;0;0;2
2020-07-27;2;1;0;0;0;0;3
2020-07-28;1;1;0;0;0;0;2
2020-07-29;2;2;0;2;0;0;6
2020-07-30;2;2;0;0;1;0;5
2020-07-31;0;0;1;2;0;0;3
2020-08-01;0;1;0;3;0;0;4
2020-08-02;0;2;0;0;0;0;2
2020-08-03;1;2;1;3;0;0;7
2020-08-04;1;3;0;1;0;0;5
2020-08-05;3;0;0;4;0;0;7
2020-08-06;0;1;1;0;1;0;3
2020-08-07;2;0;0;3;0;0;5
2020-08-08;0;1;0;2;0;0;3
2020-08-09;0;1;0;1;0;0;2
2020-08-10;1;1;0;2;0;0;4
2020-08-11;1;1;0;1;0;0;3
2020-08-12;1;1;0;0;1;0;3
2020-08-13;2;0;0;0;1;1;4
2020-08-14;2;1;0;2;0;1;6
2020-08-15;0;2;0;0;0;0;2
2020-08-16;1;0;0;3;1;0;5
2020-08-17;2;2;0;3;1;0;8
2020-08-18;1;0;0;0;0;0;1
2020-08-19;1;1;1;1;1;1;6
2020-08-20;1;1;0;5;0;0;7
2020-08-21;0;0;1;2;2;0;5
2020-08-22;2;0;0;0;1;0;3
2020-08-23;1;0;1;1;1;0;4
2020-08-24;1;0;0;1;0;1;3
2020-08-25;2;0;0;1;0;0;3
2020-08-26;2;3;0;0;1;2;8
2020-08-27;0;1;0;0;0;0;1
2020-08-28;2;0;0;1;1;0;4
2020-08-29;1;0;0;0;0;0;1
2020-08-30;2;0;0;1;0;0;3
2020-08-31;2;2;1;1;0;0;6
2020-09-01;1;0;0;0;0;0;1
2020-09-02;2;0;2;0;0;1;5
2020-09-03;2;0;0;1;0;1;4
2020-09-04;4;0;2;2;0;0;8
2020-09-05;5;0;1;4;2;0;12
2020-09-06;6;0;1;1;1;0;9
2020-09-07;5;0;1;1;0;0;7
2020-09-08;2;1;2;0;1;0;6
2020-09-09;8;1;2;1;1;0;13
2020-09-10;10;1;0;1;2;0;14
2020-09-11;4;3;0;3;1;0;11
2020-09-12;10;1;3;2;1;0;17
2020-09-13;5;2;2;1;0;0;10
2020-09-14;7;2;2;0;2;0;13
2020-09-15;9;0;0;3;1;1;14
2020-09-16;12;1;2;2;3;1;21
2020-09-17;3;3;0;3;3;1;13
2020-09-18;9;2;0;1;1;1;14
2020-09-19;10;2;4;4;4;0;24
2020-09-20;13;0;2;3;1;0;19
2020-09-21;10;1;4;1;4;1;21
2020-09-22;9;2;1;2;0;0;14
2020-09-23;12;5;2;2;3;0;24
2020-09-24;10;3;6;4;3;0;26
2020-09-25;12;1;2;1;2;0;18
2020-09-26;5;2;0;4;1;0;12
2020-09-27;10;3;3;2;1;0;19
2020-09-28;13;1;6;1;0;0;21
2020-09-29;6;0;2;4;2;0;14
2020-09-30;8;4;2;5;0;1;20
2020-10-01;7;2;4;8;2;0;23
2020-10-02;6;5;1;4;3;0;19
2020-10-03;9;0;0;2;0;0;11
2020-10-04;11;1;4;3;1;1;21
2020-10-05;15;2;2;8;2;1;30
2020-10-06;6;0;2;1;0;0;9
2020-10-07;10;2;1;3;1;0;17
2020-10-08;3;1;1;4;0;0;9
2020-10-09;3;2;3;4;2;1;15
2020-10-10;5;2;2;2;3;1;15
2020-10-11;6;1;2;3;2;0;14
2020-10-12;12;1;2;8;1;0;24
2020-10-13;8;1;3;4;1;2;19
2020-10-14;10;1;2;5;2;2;22
2020-10-15;11;0;1;4;5;0;21
2020-10-16;8;3;1;5;1;3;21
2020-10-17;8;2;1;3;1;0;15
2020-10-18;10;0;5;6;3;0;24
2020-10-19;10;5;3;5;1;1;25
2020-10-20;10;1;4;3;1;0;19
2020-10-21;13;2;4;5;1;0;25
2020-10-22;12;2;2;2;0;0;18
2020-10-23;11;5;2;3;4;2;27
2020-10-24;11;3;2;4;2;0;22
2020-10-25;13;1;7;2;3;1;27
2020-10-26;12;7;2;6;3;2;32
2020-10-27;16;1;4;9;4;1;35
2020-10-28;12;2;5;6;5;0;30
2020-10-29;18;2;8;5;4;0;37
2020-10-30;11;4;5;8;5;0;33
2020-10-31;21;5;6;4;4;0;40
2020-11-01;15;1;12;8;0;2;38
2020-11-02;21;4;8;4;3;0;40
2020-11-03;21;6;3;4;7;0;41
2020-11-04;22;11;6;7;6;0;52
2020-11-05;16;8;11;7;5;1;48
2020-11-06;14;2;6;8;2;0;32
2020-11-07;12;5;3;4;4;1;29
2020-11-08;14;7;7;6;4;1;39
2020-11-09;25;8;6;11;6;0;56
2020-11-10;15;6;6;7;2;1;37
2020-11-11;26;6;3;8;3;3;49
2020-11-12;14;3;5;10;0;2;34
2020-11-13;18;5;3;10;3;0;39
2020-11-14;16;7;2;6;2;1;34
2020-11-15;19;3;2;8;0;0;32
2020-11-16;26;6;3;11;4;0;50
2020-11-17;28;4;11;15;3;2;63
2020-11-18;19;6;7;11;3;0;46
2020-11-19;14;9;6;10;1;2;42
2020-11-20;16;4;7;11;3;1;42
2020-11-21;13;5;7;5;0;2;32
2020-11-22;23;3;5;4;4;1;40
2020-11-23;22;7;8;9;1;1;48
2020-11-24;14;5;5;11;4;0;39
2020-11-25;20;8;4;9;5;1;47
2020-11-26;20;7;11;4;3;3;48
2020-11-27;16;3;2;7;2;0;30
2020-11-28;9;5;5;8;3;1;31
2020-11-29;16;7;4;7;0;0;34
2020-11-30;26;4;9;4;1;1;45
2020-12-01;21;3;7;17;2;0;50
2020-12-02;24;5;7;12;2;4;54
2020-12-03;32;9;5;8;0;0;54
2020-12-04;26;9;4;14;2;1;56
2020-12-05;36;12;5;11;2;0;66
2020-12-06;42;13;4;10;0;0;69
2020-12-07;57;12;6;14;1;0;90
2020-12-08;39;8;4;8;3;0;62
2020-12-09;46;9;6;13;1;1;76
2020-12-10;55;17;12;14;1;1;100
2020-12-11;48;15;6;24;1;1;95
2020-12-12;56;7;6;10;4;2;85
2020-12-13;57;19;13;11;3;0;103
2020-12-14;72;25;10;17;2;0;126
2020-12-15;74;35;13;20;4;0;146
2020-12-16;91;19;11;12;6;2;141
2020-12-17;87;23;8;22;6;1;147
2020-12-18;85;27;11;17;7;2;149
2020-12-19;92;18;12;20;10;1;153
2020-12-20;67;24;11;19;7;0;128
2020-12-21;102;29;19;21;11;2;184
2020-12-22;77;31;12;19;8;0;147
2020-12-23;73;24;15;26;14;0;152
2020-12-24;67;20;7;21;6;1;122
2020-12-25;100;25;13;25;4;1;168
2020-12-26;82;17;14;21;9;1;144
2020-12-27;77;23;11;17;10;0;138
2020-12-28;89;38;33;41;8;1;210
2020-12-29;79;20;10;29;4;2;144
2020-12-30;71;24;11;17;4;0;127
2020-12-31;61;19;17;13;10;1;121
2021-01-01;79;21;17;21;10;2;150
2021-01-02;63;32;11;18;13;2;139
2021-01-03;54;27;12;10;12;1;116
2021-01-04;66;37;13;28;13;1;158
2021-01-05;43;20;15;21;6;0;105
2021-01-06;62;28;12;20;7;0;129
2021-01-07;73;22;17;17;9;1;139
2021-01-08;50;27;9;22;9;0;117
2021-01-09;62;17;14;13;7;0;113
2021-01-10;42;23;13;16;13;0;107
2021-01-11;50;24;19;24;5;1;123
2021-01-12;45;14;11;21;5;1;97
2021-01-13;57;25;6;12;5;1;106
2021-01-14;40;14;10;17;4;3;88
2021-01-15;36;21;21;15;6;0;99
2021-01-16;33;13;14;13;5;1;79
2021-01-17;41;15;12;5;7;0;80
2021-01-18;55;20;17;21;11;0;124
2021-01-19;42;21;18;10;14;0;105
2021-01-20;30;9;10;6;11;0;66
2021-01-21;47;16;9;9;7;1;89
2021-01-22;39;15;9;11;6;1;81
2021-01-23;35;14;2;4;3;1;59
2021-01-24;26;12;6;8;8;0;60
2021-01-25;39;14;8;7;5;0;73
2021-01-26;28;9;3;5;5;0;50
2021-01-27;28;15;7;5;3;0;58
2021-01-28;20;12;7;7;5;0;51
2021-01-29;18;12;5;6;6;1;48
2021-01-30;13;6;2;3;5;0;29
2021-01-31;20;5;6;7;2;1;41
2021-02-01;23;8;7;5;3;1;47
2021-02-02;19;3;5;3;6;0;36
2021-02-03;8;10;4;2;6;2;32
2021-02-04;18;7;3;4;1;0;33
2021-02-05;17;12;2;4;3;1;39
2021-02-06;6;2;5;2;3;3;21
2021-02-07;21;3;2;1;2;1;30
2021-02-08;13;9;5;4;4;0;35
2021-02-09;18;8;6;1;7;0;40
2021-02-10;18;7;5;5;1;0;36
2021-02-11;8;6;2;5;1;1;23
2021-02-12;11;3;5;2;1;0;22
2021-02-13;14;7;9;2;1;0;33
2021-02-14;6;9;2;3;1;0;21
2021-02-15;6;7;4;4;4;0;25
2021-02-16;9;4;3;2;1;0;19
2021-02-17;8;4;2;4;4;0;22
2021-02-18;11;6;5;4;5;0;31
2021-02-19;12;7;9;1;1;1;31
2021-02-20;13;3;4;1;2;1;24
2021-02-21;6;3;6;1;4;0;20
2021-02-22;9;8;4;4;3;0;28
2021-02-23;8;6;4;2;4;0;24
2021-02-24;15;4;6;3;4;0;32
2021-02-25;13;4;11;6;0;0;34
2021-02-26;8;4;10;3;1;0;26
2021-02-27;12;6;5;4;0;0;27
2021-02-28;12;3;5;1;1;0;22
2021-03-01;7;11;4;2;0;1;25
2021-03-02;16;8;8;2;2;1;37
2021-03-03;14;1;9;1;2;1;28
2021-03-04;14;2;8;3;1;1;29
2021-03-05;6;5;6;5;0;1;23
2021-03-06;17;6;8;5;3;1;40
2021-03-07;9;5;7;1;0;0;22
2021-03-08;12;4;5;2;0;0;23
2021-03-09;12;10;10;1;0;0;33
2021-03-10;12;7;10;1;0;0;30
2021-03-11;16;5;5;2;1;0;29
2021-03-12;7;1;4;2;1;1;16
2021-03-13;15;7;7;2;0;0;31
2021-03-14;10;4;8;2;1;0;25
2021-03-15;10;8;2;5;0;0;25
2021-03-16;15;4;10;4;1;1;35
2021-03-17;10;6;5;4;0;2;27
2021-03-18;9;6;10;0;0;1;26
2021-03-19;7;4;3;3;1;0;18
2021-03-20;10;4;3;3;1;0;21
2021-03-21;10;3;11;5;2;0;31
2021-03-22;27;5;4;4;1;1;42
2021-03-23;9;3;7;3;2;0;24
2021-03-24;10;4;10;3;2;0;29
2021-03-25;20;1;11;7;1;0;40
2021-03-26;18;0;7;4;3;1;33
2021-03-27;20;6;4;6;1;0;37
2021-03-28;15;7;5;5;1;0;33
2021-03-29;19;6;8;9;7;2;51
2021-03-30;26;4;2;2;0;1;35
2021-03-31;19;9;8;7;2;0;45
2021-04-01;17;0;8;8;0;1;34
2021-04-02;15;2;9;2;2;1;31
2021-04-03;20;3;3;2;2;0;30
2021-04-04;17;3;5;1;2;0;28
2021-04-05;15;3;4;2;0;0;24
2021-04-06;22;5;5;7;4;1;44
2021-04-07;16;3;2;4;5;1;31
2021-04-08;14;9;2;4;3;2;34
2021-04-09;17;3;3;4;3;0;30
2021-04-10;14;3;5;5;0;1;28
2021-04-11;14;3;4;4;0;0;25
2021-04-12;15;1;7;5;2;0;30
2021-04-13;12;6;5;4;3;3;33
2021-04-14;12;2;3;7;4;2;30
2021-04-15;15;9;4;5;1;0;34
2021-04-16;11;4;5;6;0;1;27
2021-04-17;17;1;8;6;1;0;33
2021-04-18;16;5;6;6;3;2;38
2021-04-19;26;8;3;4;2;0;43
2021-04-20;17;5;2;10;1;2;37
2021-04-21;20;2;3;6;0;1;32
2021-04-22;14;5;5;3;1;2;30
2021-04-23;11;3;3;8;1;0;26
2021-04-24;12;10;4;2;1;1;30
2021-04-25;5;3;3;2;1;1;15
2021-04-26;7;6;1;7;3;2;26
2021-04-27;18;3;4;11;4;0;40
2021-04-28;18;5;4;4;1;1;33
2021-04-29;19;4;3;8;4;2;40
2021-04-30;11;3;4;1;1;2;22
2021-05-01;13;3;2;5;2;0;25
2021-05-02;12;4;2;5;4;0;27
2021-05-03;10;6;1;3;6;1;27
2021-05-04;14;2;1;4;5;0;26
2021-05-05;10;3;4;4;1;0;22
2021-05-06;7;3;5;10;1;0;26
2021-05-07;18;5;0;11;2;2;38
2021-05-08;21;6;4;3;1;1;36
2021-05-09;10;7;3;5;2;0;27
2021-05-10;31;2;1;8;6;0;48
2021-05-11;15;3;1;3;0;0;22
2021-05-12;22;3;4;7;2;0;38
2021-05-13;17;8;5;5;2;0;37
2021-05-14;18;7;5;6;7;2;45
2021-05-15;11;10;1;6;2;2;32
2021-05-16;13;7;8;3;0;1;32
2021-05-17;9;8;2;4;2;0;25
2021-05-18;9;8;1;6;1;1;26
2021-05-19;19;2;4;10;2;0;37
2021-05-20;11;2;2;4;3;0;22
2021-05-21;20;8;5;4;1;0;38
2021-05-22;8;1;7;5;1;1;23
2021-05-23;17;3;4;1;2;0;27
2021-05-24;13;3;3;2;2;0;23
2021-05-25;13;5;7;3;2;0;30
2021-05-26;11;3;3;5;6;0;28
2021-05-27;15;7;8;4;2;1;37
2021-05-28;17;6;5;3;2;0;33
2021-05-29;17;1;6;1;0;1;26
2021-05-30;13;1;3;2;1;0;20
2021-05-31;14;4;3;8;7;1;37
2021-06-01;11;8;2;3;4;0;28
2021-06-02;13;1;1;3;5;0;23
2021-06-03;9;6;4;4;3;1;27
2021-06-04;7;5;2;5;1;1;21
2021-06-05;7;1;2;2;2;0;14
2021-06-06;10;1;0;2;0;0;13
2021-06-07;10;3;5;6;2;0;26
2021-06-08;4;1;4;2;1;1;13
2021-06-09;12;4;2;8;3;0;29
2021-06-10;3;6;1;3;4;0;17
2021-06-11;5;2;2;2;1;0;12
2021-06-12;4;3;2;1;0;0;10
2021-06-13;11;3;1;0;3;0;18
2021-06-14;9;3;0;4;2;0;18
2021-06-15;5;0;2;4;0;0;11
2021-06-16;4;1;0;2;2;0;9
2021-06-17;4;2;0;0;1;0;7
2021-06-18;5;2;0;0;3;0;10
2021-06-19;7;1;0;1;3;0;12
2021-06-20;3;4;1;0;2;0;10
2021-06-21;2;1;1;0;1;1;6
2021-06-22;6;0;1;1;0;1;9
2021-06-23;4;1;0;1;1;0;7
2021-06-24;3;0;2;2;1;0;8
2021-06-25;2;4;0;0;1;1;8
2021-06-26;3;0;1;0;1;1;6
2021-06-27;2;2;0;0;0;0;4
2021-06-28;3;0;0;0;0;0;3
2021-06-29;2;0;0;0;0;1;3
2021-06-30;4;2;1;1;0;0;8
2021-07-01;6;2;1;1;1;0;11
2021-07-02;4;0;0;2;0;0;6
2021-07-03;0;0;0;2;1;0;3
2021-07-04;2;2;0;0;0;0;4
2021-07-05;7;1;0;2;0;0;10
2021-07-06;4;0;0;1;0;0;5
2021-07-07;1;2;1;2;1;0;7
2021-07-08;6;2;0;3;1;1;13
2021-07-09;4;1;1;1;0;0;7
2021-07-10;3;0;0;4;0;0;7
2021-07-11;7;1;1;3;0;0;12
2021-07-12;8;1;2;4;0;0;15
2021-07-13;13;3;0;3;0;0;19
2021-07-14;6;3;2;4;0;0;15
2021-07-15;7;2;2;3;1;1;16
2021-07-16;9;1;4;1;0;0;15
2021-07-17;4;1;1;2;1;1;10
2021-07-18;5;2;3;1;1;0;12
2021-07-19;12;3;2;1;0;0;18
2021-07-20;9;2;2;1;0;1;15
2021-07-21;6;1;1;5;0;0;13
2021-07-22;4;4;2;4;0;0;14
2021-07-23;7;1;1;4;0;1;14
2021-07-24;5;1;0;2;0;0;8
2021-07-25;6;3;5;1;1;1;17
2021-07-26;7;1;4;5;0;0;17
2021-07-27;12;2;4;5;1;0;24
2021-07-28;7;3;4;1;0;0;15
2021-07-29;8;2;2;3;1;0;16
2021-07-30;11;2;2;2;2;0;19
2021-07-31;2;2;1;4;1;1;11
2021-08-01;5;3;2;1;0;1;12
2021-08-02;5;2;2;3;0;0;12
2021-08-03;7;7;1;2;0;2;19
2021-08-04;6;3;1;1;0;3;14
2021-08-05;11;1;6;6;1;1;26
2021-08-06;9;3;3;2;1;1;19
2021-08-07;12;1;4;3;1;0;21
2021-08-08;7;1;7;1;0;1;17
2021-08-09;15;0;3;7;1;1;27
2021-08-10;9;2;3;12;1;1;28
2021-08-11;17;4;3;3;3;1;31
2021-08-12;11;0;6;7;1;1;26
2021-08-13;8;4;3;4;2;0;21
2021-08-14;10;1;5;7;2;0;25
2021-08-15;13;1;7;7;2;0;30
2021-08-16;12;4;5;4;3;1;29
2021-08-17;10;3;5;6;2;0;26
2021-08-18;14;8;8;3;1;0;34
2021-08-19;14;4;4;5;4;1;32
2021-08-20;15;2;6;3;2;0;28
2021-08-21;18;6;6;8;1;1;40
2021-08-22;19;3;2;6;4;0;34
2021-08-23;15;1;5;4;0;1;26
2021-08-24;12;6;4;7;5;0;34
2021-08-25;22;4;3;2;1;1;33
2021-08-26;10;5;3;5;4;0;27
2021-08-27;17;6;6;4;3;2;38
2021-08-28;15;1;6;3;1;0;26
2021-08-29;7;4;2;4;1;0;18
2021-08-30;14;4;6;9;5;2;40
2021-08-31;18;3;4;1;2;2;30
2021-09-01;15;2;2;4;6;1;30
2021-09-02;12;3;6;3;3;3;30
2021-09-03;10;2;2;3;1;0;18
2021-09-04;14;3;0;6;2;0;25
2021-09-05;13;2;0;4;1;1;21
2021-09-06;22;0;1;3;3;0;29
2021-09-07;14;4;2;8;2;1;31
2021-09-08;13;1;1;7;1;0;23
2021-09-09;12;6;3;4;1;1;27
2021-09-10;7;4;2;4;1;0;18
2021-09-11;7;2;0;2;0;0;11
2021-09-12;5;4;2;5;0;0;16
2021-09-13;10;2;2;5;3;0;22
2021-09-14;5;2;0;2;1;1;11
2021-09-15;8;1;1;1;2;0;13
2021-09-16;7;4;1;2;0;0;14
2021-09-17;6;2;1;0;2;1;12
2021-09-18;3;1;4;0;1;1;10
2021-09-19;3;2;2;2;0;2;11
2021-09-20;8;3;1;2;2;1;17
2021-09-21;6;2;1;0;3;0;12
2021-09-22;4;3;0;1;3;2;13
2021-09-23;5;3;1;0;0;1;10
2021-09-24;3;4;3;2;0;1;13
2021-09-25;6;1;2;1;0;0;10
2021-09-26;9;2;6;0;1;1;19
2021-09-27;4;3;4;1;0;0;12
2021-09-28;3;2;3;0;1;0;9
2021-09-29;6;2;1;3;4;0;16
2021-09-30;6;2;2;2;0;0;12
2021-10-01;9;4;5;2;0;2;22
2021-10-02;4;0;1;1;0;0;6
2021-10-03;5;1;0;2;0;1;9
2021-10-04;10;4;1;1;1;0;17
2021-10-05;12;3;1;1;4;1;22
2021-10-06;13;5;2;0;0;0;20
2021-10-07;2;2;1;3;2;1;11
2021-10-08;8;2;0;1;0;1;12
2021-10-09;10;2;2;1;1;1;17
2021-10-10;5;4;1;3;1;0;14
2021-10-11;7;4;4;1;1;0;17
2021-10-12;8;3;0;2;0;0;13
2021-10-13;20;3;4;2;7;2;38
2021-10-14;13;3;3;3;1;0;23
2021-10-15;18;5;2;2;2;0;29
2021-10-16;13;5;1;2;2;1;24
2021-10-17;15;3;1;1;0;0;20
2021-10-18;24;3;3;3;2;1;36
2021-10-19;15;2;1;3;0;1;22
2021-10-20;20;6;5;3;2;2;38
2021-10-21;17;5;4;6;1;1;34
2021-10-22;26;4;1;6;4;1;42
2021-10-23;23;2;3;1;3;1;33
2021-10-24;23;7;4;6;3;0;43
2021-10-25;22;3;4;5;2;1;37
2021-10-26;18;8;4;4;2;0;36
2021-10-27;29;10;2;7;3;3;54
2021-10-28;26;6;3;6;1;1;43
2021-10-29;27;8;7;2;3;1;48
2021-10-30;23;8;5;1;4;2;43
2021-10-31;29;4;7;3;2;1;46
2021-11-01;34;10;8;4;6;1;63
2021-11-02;29;11;9;5;2;3;59
2021-11-03;25;5;9;4;7;1;51
2021-11-04;35;12;10;3;2;0;62
2021-11-05;25;7;4;5;5;2;48
2021-11-06;23;7;8;3;1;2;44
2021-11-07;31;9;11;2;3;0;56
2021-11-08;36;6;8;9;4;0;63
2021-11-09;27;5;12;4;3;1;52
2021-11-10;29;19;8;6;5;1;68
2021-11-11;29;11;15;6;3;1;65
2021-11-12;32;18;17;3;6;1;77
2021-11-13;32;14;6;6;3;2;63
2021-11-14;28;18;9;5;6;1;67
2021-11-15;41;13;15;13;4;0;86
2021-11-16;34;13;15;13;7;0;82
2021-11-17;36;15;9;10;6;1;77
2021-11-18;33;16;17;5;5;1;77
2021-11-19;24;24;14;6;9;1;78
2021-11-20;41;11;13;13;3;2;83
2021-11-21;34;8;15;4;10;1;72
2021-11-22;41;11;15;12;9;2;90
2021-11-23;38;22;14;6;1;1;82
2021-11-24;39;16;7;5;5;1;73
2021-11-25;39;12;14;13;7;2;87
2021-11-26;42;12;20;10;3;0;87
2021-11-27;31;13;14;7;6;1;72
2021-11-28;32;18;8;11;8;0;77
2021-11-29;35;16;16;7;8;1;83
2021-11-30;44;14;16;14;8;1;97
2021-12-01;38;15;8;6;14;3;84
2021-12-02;39;15;13;13;7;0;87
2021-12-03;36;18;18;15;11;0;98
2021-12-04;41;14;11;12;12;0;90
2021-12-05;37;10;13;11;9;0;80
2021-12-06;53;20;10;15;11;3;112
2021-12-07;40;21;13;12;7;0;93
2021-12-08;48;22;17;11;2;0;100
2021-12-09;47;13;8;13;2;2;85
2021-12-10;54;17;24;12;10;1;118
2021-12-11;34;13;18;6;5;0;76
2021-12-12;56;13;14;9;3;0;95
2021-12-13;51;23;11;20;9;3;117
2021-12-14;53;19;12;12;3;0;99
2021-12-15;76;26;13;9;10;1;135
2021-12-16;52;18;19;13;9;1;112
2021-12-17;59;14;22;16;13;0;124
2021-12-18;53;19;14;11;6;2;105
2021-12-19;49;12;13;13;7;1;95
2021-12-20;64;21;14;16;6;2;123
2021-12-21;63;24;11;20;10;0;128
2021-12-22;71;22;18;19;8;3;141
2021-12-23;68;31;11;21;5;1;137
2021-12-24;41;14;5;17;11;1;89
2021-12-25;65;20;15;14;4;0;118
2021-12-26;51;25;14;13;4;0;107
2021-12-27;82;29;30;26;7;5;179
2021-12-28;85;32;21;22;9;2;171
2021-12-29;91;34;16;28;8;2;179
2021-12-30;84;30;18;20;13;0;165
2021-12-31;55;20;15;18;7;5;120
2022-01-01;80;31;25;21;11;1;169
2022-01-02;83;32;15;21;19;1;171
2022-01-03;104;38;27;30;17;4;220
2022-01-04;83;33;15;27;14;5;177
2022-01-05;70;29;19;22;13;1;154
2022-01-06;80;38;26;17;8;0;169
2022-01-07;68;18;17;23;10;0;136
2022-01-08;73;21;9;12;6;1;122
2022-01-09;64;29;26;23;13;1;156
2022-01-10;64;44;27;27;20;3;185
2022-01-11;95;30;32;23;19;1;200
2022-01-12;90;34;27;30;7;1;189
2022-01-13;102;35;23;29;10;1;200
2022-01-14;78;33;17;34;15;2;179
2022-01-15;60;38;20;29;15;3;165
2022-01-16;80;32;32;37;15;3;199
2022-01-17;106;48;36;39;18;2;249
2022-01-18;96;43;39;45;16;1;240
2022-01-19;95;36;27;39;15;2;214
2022-01-20;97;35;38;30;19;5;224
2022-01-21;101;46;34;23;18;1;223
2022-01-22;107;34;27;27;13;4;212
2022-01-23;116;48;30;26;16;0;236
2022-01-24;140;48;42;44;16;1;291
2022-01-25;113;63;57;30;27;3;293
2022-01-26;123;47;44;50;17;1;282
2022-01-27;134;50;41;56;15;1;297
2022-01-28;106;45;46;40;13;6;256
2022-01-29;97;44;38;41;7;3;230
2022-01-30;109;40;33;35;23;4;244
2022-01-31;124;69;60;57;16;2;328
2022-02-01;141;66;52;43;29;4;335
2022-02-02;116;90;53;58;32;4;353
2022-02-03;113;59;69;64;34;8;347
2022-02-04;134;61;63;59;35;3;355
2022-02-05;100;60;55;49;23;3;290
2022-02-06;104;59;66;51;26;2;308
2022-02-07;149;71;97;84;28;0;429
2022-02-08;121;70;90;83;44;2;410
2022-02-09;151;76;89;75;38;0;429
2022-02-10;123;62;77;98;35;4;399
2022-02-11;130;68;83;75;43;1;400
2022-02-12;81;48;53;58;41;0;281
2022-02-13;124;47;59;73;38;3;344
2022-02-14;149;76;96;72;57;3;453
2022-02-15;137;69;83;79;59;7;434
2022-02-16;126;65;87;105;47;2;432
2022-02-17;119;75;114;93;44;5;450
2022-02-18;121;59;72;61;51;2;366
2022-02-19;71;48;54;65;56;2;296
2022-02-20;112;62;68;68;34;2;346
2022-02-21;145;86;91;100;52;2;476
2022-02-22;93;73;96;77;50;2;391
2022-02-23;98;52;88;74;65;4;381
2022-02-24;124;65;79;64;48;1;381
2022-02-25;91;53;70;76;57;3;350
2022-02-26;64;41;53;51;24;2;235
2022-02-27;83;39;54;43;37;2;258
2022-02-28;110;57;89;78;55;4;393
2022-03-01;91;51;78;71;37;2;330
2022-03-02;92;47;54;68;31;2;294
2022-03-03;95;51;55;53;41;1;296
2022-03-04;95;66;70;57;49;0;337
2022-03-05;61;37;43;36;30;1;208
2022-03-06;55;38;60;55;22;0;230
2022-03-07;76;55;66;50;46;3;296
2022-03-08;65;42;77;60;25;4;273
2022-03-09;84;47;46;41;40;3;261
2022-03-10;49;43;63;49;28;0;232
2022-03-11;55;44;49;51;33;2;234
2022-03-12;50;36;49;44;13;1;193
2022-03-13;54;21;35;35;28;1;174
2022-03-14;63;38;56;40;15;2;214
